neogeo=Neo Geo BIOS
razmataz=Razzmatazz
rastsaga=Rastan Saga (Japan)
rbff2=Real Bout Fatal Fury 2 - The Newcomers / Real Bout Garou Densetsu 2 - the newcomers
rbff1=Real Bout Fatal Fury / Real Bout Garou Densetsu
rastanu=Rastan (US set 1)
rastan=Rastan (World)
rastsag2=Rastan Saga 2 (Japan)
rastanu2=Rastan (US set 2)
rbffspec=Real Bout Fatal Fury Special / Real Bout Garou Densetsu Special
redlin2p=Redline Racer (2 players)
redbaron=Red Baron
regulus=Regulus
redufo=Defend the Terra Attack on the Red UFO (bootleg)
rdaction=Rad Action
rbtapper=Tapper (Root Beer)
redalert=Red Alert
reactor=Reactor
rainbowe=Rainbow Islands (Extra)
rainbow=Rainbow Islands
rallyx=Rally X
rallybik=Rally Bike / Dash Yarou
raidena=Raiden (Alternate Hardware)
raiden=Raiden
raimais=Raimais (Japan)
raidenk=Raiden (Korea)
rallyxm=Rally X (Midway)
rampartj=Rampart (Japan, 2-player Joystick)
rampart=Rampart (3-player Trackball)
ragnagrd=Operation Ragnagard / Shin-Oh-Ken
ramprt2p=Rampart (2-player Joystick)
rambo3a=Rambo III (set 2, US)
rambo3=Rambo III (set 1, Europe)
rampage2=Rampage (revision 2)
rampage=Rampage (revision 3)
roadf2=Road Fighter (set 2)
roadf=Road Fighter (set 1)
robby=Robby Roto
roadrunn=Road Runner
rmpgwt=Rampage: World Tour (rev 1.3)
ripoff=Rip Off
roadblst=Road Blasters
rmpgwt11=Rampage: World Tour (rev 1.1)
roboarmy=Robo Army
robotron=Robotron (Solid Blue label)
robotbwl=Robot Bowl
rockmanj=Rockman - The Power Battle (Japan)
robotryo=Robotron (Yellow/Orange label)
robocopb=Robocop (World bootleg)
robocop=Robocop (World revision 3)
robocpu0=Robocop (US revision 0)
robocopu=Robocop (US revision 1)
rescrdsa=Rescue Raider (Stand-Alone)
rescraid=Rescue Raider
retofin1=Return of the Invaders (bootleg set 1)
rescue=Rescue
relief=Relief Pitcher (set 1)
regulusu=Regulus (not encrypted)
repulse=Repulse
relief2=Relief Pitcher (set 2)
retofin2=Return of the Invaders (bootleg set 2)
ringohja=Ring no Ohja (Japan)
ringking=Ring King (set 1)
ripcord=Rip Cord
riotcity=Riot City
rf2=Konami RF2 - Red Fighter
retofinv=Return of the Invaders
ringkin2=Ring King (set 2)
ridhero=Riding Hero
radrad=Radical Radial
punisher=The Punisher (World)
punchout=Punch-Out!!
punishru=The Punisher (US)
punishrj=The Punisher (Japan)
pulirulj=PuLiRuLa (Japan)
pulirula=PuLiRuLa (World)
pulstar=Pulstar
pulsar=Pulsar
punkshot=Punk Shot (4 Players)
pyros=Pyros (US)
puzzledp=Puzzle De Pon
qadj=Quiz & Dragons (Japan)
qad=Quiz & Dragons (US)
puzbobb=Puzzle Bobble (Japan
punksht2=Punk Shot (2 Players)
puzzldpr=Puzzle De Pon R
puzlclub=Puzzle Club (Japan prototype)
powerdrv=Power Drive
pow=P.O.W. - Prisoners of War (US)
powj=Datsugoku - Prisoners of War (Japan)
powerins=Power Instinct (USA) [bootleg]
potogold=Pot of Gold
portman=Port Man
poundfou=Pound for Pound (US)
poundfor=Pound for Pound (World)
prehisle=Prehistoric Isle in 1930 (World)
psychos=Psycho Soldier (US)
psychic5=Psychic 5
puckman=New Puck-X
psychosj=Psycho Soldier (Japan)
psoldier=Perfect Soldiers (Japan)
prehislu=Prehistoric Isle in 1930 (US)
pspikes2=Power Spikes II
pspikes=Power Spikes (Korea)
qbert=Q*bert (US)
quester=Quester (Japan)
quartrba=Quarterback (set 2)
quizdais=Quiz Daisousa Sen - The Last Count Down
quizdai2=Quiz Meintantei Neo Geo - Quiz Daisousa Sen Part 2
quartet2=Quartet II
quartet=Quartet
quarth=Quarth (Japan)
quartetj=Quartet (Japan)
quizhq=Quiz HQ (Japan)
rabiolep=Rabio Lepus (Japan)
qzshowby=Quiz Sekai wa SHOW by shobai (Japan)
radarscp=Radar Scope
rackemup=Rack 'em Up
qwakprot=Qwak (prototype)
quizkof=Quiz King of Fighters
qzquest=Quiz Quest - Hime to Yuusha no Monogatari (Japan)
qzchikyu=Quiz Chikyu Bouei Gun (Japan)
qix2=Qix II (Tournament)
qix=Qix (set 1)
qixb=Qix (set 3)
qixa=Qix (set 2)
qbertqub=Q*bert's Qubes
qbertjp=Q*bert (Japan)
qcrayon2=Quiz Crayon Shinchan Orato Asobo (Japan)
qcrayon=Quiz Crayon Shinchan (Japan)
qjinsei=Quiz Jinsei Gekijoh (Japan)
quantum1=Quantum (rev 1)
quantum=Quantum (rev 2)
quarterb=Quarterback
quantump=Quantum (prototype)
qtono1=Quiz Tonosama no Yabou (Japan)
qsangoku=Quiz Sangokushi (Japan)
qtorimon=Quiz Torimonochou (Japan)
qtono2=Quiz Tonosama no Yabou 2 Zenkoku-ban (Japan)
sf1=Street Fighter (World)
sercharu=SAR - Search And Rescue (US)
sf1us=Street Fighter (US)
sf1jp=Street Fighter (Japan)
sengoku2=Sengoku 2 / Sengoku Denshou 2
sengoku=Sengoku / Sengoku Denshou (set 1)
sentetst=Sente Diagnostic Cartridge
senjyo=Senjyo
sf2=Street Fighter II - The World Warrior (World 910214)
sf2ceb=Street Fighter II' - Champion Edition (US rev B)
sf2cea=Street Fighter II' - Champion Edition (US rev A)
sf2e=Street Fighter II - The World Warrior (US 910228)
sf2cej=Street Fighter II' - Champion Edition (Japan)
sf2accp2=Street Fighter II' - Champion Edition (Accelerator Pt.II)
sf2a=Street Fighter II - The World Warrior (US 910206)
sf2ce=Street Fighter II' - Champion Edition (World)
sf2b=Street Fighter II - The World Warrior (US 910214)
sdodgeb=Super Dodge Ball / Kunio no Nekketsu Toukyuu Densetsu
sdioj=SDI - Strategic Defense Initiative (Japan)
searchar=SAR - Search And Rescue (World)
sdungeon=Space Dungeon
screwloo=Screw Loose (prototype)
scregg=Scrambled Egg
sdi=SDI - Strategic Defense Initiative
sctionza=Section Z (set 2)
seawolf=Sea Wolf
seganinu=Sega Ninja (not encrypted)
seganinj=Sega Ninja
sengokh=Sengoku / Sengoku Denshou (set 2)
seicross=Seicross
secretag=Secret Agent (World)
seawolf2=Sea Wolf II
sectrzon=Sector Zone
sectionz=Section Z (set 1)
sf2j=Street Fighter II - The World Warrior (Japan 911210)
sheriff=Sheriff
shdancrj=Shadow Dancer (Japan)
shinobi=Shinobi (set 1)
shimpact=Super High Impact (rev LA1 09/30/91)
sharrier=Space Harrier
sharkatt=Shark Attack
shdancer=Shadow Dancer (US)
shdancbl=Shadow Dancer (bootleg)
shinobia=Shinobi (set 2)
shollow=Satan's Hollow (set 1)
shocktro=Shock Troopers
shootoub=Shoot Out (Korean Bootleg)
shollow2=Satan's Hollow (set 2)
shinobl=Shinobi (bootleg)
shinobib=Shinobi (set 3)
shocktr2=Shock Troopers - 2nd Squad
shisen=Shisensho - Joshiryo-Hen (Japan)
sfeverbw=Space Fever (black and white)
sf2tj=Street Fighter II' Turbo - Hyper Fighting (Japan)
sformula=Super Formula (Japan)
sfootbal=Street Football
sf2rb=Street Fighter II' - Champion Edition (Rainbow)
sf2jb=Street Fighter II - The World Warrior (Japan 910214)
sf2t=Street Fighter II' - Hyper Fighting (US)
sf2red=Street Fighter II' - Champion Edition (Red Wave)
sfposeid=Sea Fighter Poseidon
shangon=Super Hang-On
shanghai=Shanghai
shaolins=Shao-Lin's Road
shangonb=Super Hang-On (bootleg)
shadowld=Shadow Land
shackled=Shackled (US)
shangha3=Shanghai III (Japan)
shadoww=Shadow Warriors (US)
rtype=R-Type (Japan)
rthundro=Rolling Thunder (old version)
rtype2j=R-Type II (Japan)
rtype2=R-Type II
rthun2=Rolling Thunder 2
rpunch=Rabbit Punch (US)
rthunder=Rolling Thunder (new version)
rthun2j=Rolling Thunder 2 (Japan)
rtypeleo=R-Type Leo (Japan)
rushcrsh=Rush & Crash (Japan)
rushatck=Rush'n Attack
rygar2=Rygar (US set 2)
rygar=Rygar (US set 1)
rtypeu=R-Type (US)
rtypepj=R-Type (Japan prototype)
runark=Runark (Japan)
rugrats=Rug Rats
rodlandj=RodLand (Japan)
rodland=RodLand (World)
rollerg=Rollergames (US)
roishtar=The Return of Ishtar
rockragj=Koi no Hotrock (Japan)
rockrage=Rock 'n Rage (World?)
rocnropk=Roc'n Rope (Kosuka)
rocnrope=Roc'n Rope
rollergj=Rollergames (Japan)
route16b=Route 16 (bootleg)
route16=Route 16
rpatrolb=River Patrol (bootleg)=
royalmah=Royal Mahjong
rompers=Rompers (Japan)
rollingc=Rolling Crash / Moon Base
roundup=Round-Up
romperso=Rompers (Japan old version)
rygarj=Argus no Senshi (Japan)
sbrkout=Super Breakout
sboblbob=Super Bobble Bobble
scion=Scion
schasrcv=Space Chaser (CV version)
sbasebal=Super Champion Baseball
sbagmans=Super Bagman (Stern)
sbbros=Super Buster Bros (US)
sbasketb=Super Basketball
scionc=Scion (Cinematronics)
scramblb=Scramble (bootleg on Galaxian hardware)
scontraj=Super Contra (Japan)
scrambls=Scramble (Stern)
scramble=Scramble
scobrab=Super Cobra (bootleg)
scobra=Super Cobra
scontra=Super Contra
scobras=Super Cobra (Stern)
samsho2=Samurai Shodown II / Shin Samurai Spirits - Haohmaru jigokuhen
samsho=Samurai Shodown / Samurai Spirits
samsho4=Samurai Shodown IV - Amakusa's Revenge / Samurai Spirits - Amakusa Kourin
samsho3=Samurai Shodown III / Samurai Spirits - Zankurou Musouken
safari=Safari
ryukendn=Ninja Ryukenden (Japan)
salamand=Salamander
safarir=Safari Rally=
samurai=Samurai (Sega)
savagere=Savage Reign / Fu'un Mokushiroku - kakutou sousei
sauro=Sauro
sbagman=Super Bagman
savgbees=Savage Bees
sasuke=Sasuke vs. Commander
sarge=Sarge
saturn=Saturn
satansat=Satan of Saturn
popflame=Pop Flamer (set 1)
mysticm=Mystic Marathon
myherok=My Hero (Korea)
mystston=Mysterious Stones
mysticri=Mystic Riders (World)
mx5000=MX5000
mutnat=Mutation Nation
myheroj=Seishun Scandal (Japan)
myhero=My Hero (US)
nam1975=NAM-1975
naughtya=Naughty Boy (bootleg)
nastarw=Nastar Warrior (US)
naughtyc=Naughty Boy (Cinematronics)
naughtyb=Naughty Boy
narc=Narc (rev 7.00)
nametune=Name That Tune
nastar=Nastar (World)
narc3=Narc (rev 3.20)
mrvikinj=Mister Viking (Japan)
mrviking=Mister Viking
mslug2=Metal Slug 2 - Super Vehicle-001/II
mslug=Metal Slug - Super Vehicle-001
mrheli=Mr. HELI no Dai-Bouken
mrgoemon=Mr. Goemon (Japan)
mrlo=Mr. Lo!
mrjong=Mr. Jong (Japan)
mspacatk=Ms. Pac-Man Plus
mtrap3=Mouse Trap (version 3)
mtrap=Mouse Trap (version 5)
mtwins=Mega Twins (World)
mtrap4=Mouse Trap (version 4)
msword=Magic Sword - Heroic Fantasy (World)
mspacman=Ms. Pac-Man
mswordu=Magic Sword - Heroic Fantasy (US)
mswordj=Magic Sword (Japan)
navalone=Navalone
ninjak2a=Ninja Kid II (set 2)
ninjak=Ninja Kids (World)
ninjakd2=Ninja Kid II (set 1)
ninjak2b=Ninja Kid II (set 3)
newsin7=New Sinbad 7
neomrdo=Neo Mr. Do!
nibblera=Nibbler (set 2)
nibbler=Nibbler (set 1)
ninjakj=Ninja Kids (Japan)
nov2001u=Nova 2001 (US)
nomnlndg=No Man's Land (Gottlieb)
npacmod=PuckMan (harder?)
nova2001=Nova 2001 (Japan)
ninjemak=Ninja Emaki (US)
ninjamas=Ninja Master's - haoh-ninpo-cho
nomnlnd=No Man's Land
nitedrvr=Night Driver
nbajamte=NBA Jam TE (rev 4.0 03/23/94)
nbajamt3=NBA Jam TE (rev 3.0 03/04/94)
ncombat=Ninja Combat
nbamaxht=NBA Maximum Hangtime (rev 1.0)
nbajamr2=NBA Jam (rev 2.00 02/10/93)
nbajam=NBA Jam (rev 3.01 04/07/93)
nbajamt2=NBA Jam TE (rev 2.0 01/28/94)
nbajamt1=NBA Jam TE (rev 1.0 01/17/94)
ncommand=Ninja Commando
neobombe=Neo Bomberman
nemoj=Nemo (Japan)
neodrift=Neo Drift Out - New Technology
neocup98=Neo-Geo Cup '98 - The Road to the Victory
nemesis=Nemesis (hacked?)
nebulbee=Nebulous Bee
nemo=Nemo (World)
nemesuk=Nemesis (World?)
mjnquesb=Mahjong Quest (No Nudity)
mjleague=Major League
mk=Mortal Kombat (rev 5.0 T-Unit 03/19/93)
mjnquest=Mahjong Quest (Japan)
missile=Missile Command (set 1)
mirninja=Mirai Ninja (Japan)
mizubaku=Mizubaku Daibouken (Japan)
missile2=Missile Command (set 2)
mk2=Mortal Kombat II (rev L3.1)
mkla1=Mortal Kombat (rev 1.0 08/08/92)
mk3r20=Mortal Kombat 3 (rev 2.0)
mkla3=Mortal Kombat (rev 3.0 08/31/92)
mkla2=Mortal Kombat (rev 2.0 08/18/92)
mk2r32=Mortal Kombat II (rev L3.2 (European))
mk2r14=Mortal Kombat II (rev L1.4)
mk3r10=Mortal Kombat 3 (rev 1.0)
mk3=Mortal Kombat 3 (rev 2.1)
midresj=Midnight Resistance (Japan)
midres=Midnight Resistance (World)
miexchng=Money Puzzle Exchanger / Money Idol Exchanger
midresu=Midnight Resistance (US)
mia=Missing in Action (version T)
mhavocrv=Major Havoc (Return to Vax)
miaj=Missing in Action (Japan)
mia2=Missing in Action (version S)
mikie=Mikie
minigol2=Mini Golf (set 2)
minefld=Minefield
minivadr=Minivader
minigolf=Mini Golf (set 1)
mikiej=Shinnyuushain Tooru-kun
mikiehs=Mikie (High School Graffiti)
minasan=Minnasanno Okagesamadesu
milliped=Millipede
mkla4=Mortal Kombat (rev 4.0 09/28/92)
mosyougi=Syougi No Tatsujin - Master of Syougi
moonwlkb=Moon Walker (bootleg)
motos=Motos
motorace=MotoRace USA
moonwalk=Moon Walker (Set 1)
moonqsr=Moon Quasar
moonwlka=Moon Walker (Set 2)
moonwar2=Moon War II (set 1)
mpatrol=Moon Patrol
mrdot=Mr. Do! (Taito)
mrdofix=Mr. Do! (bugfixed)
mrdu=Mr. Du!
mrdoy=Mr. Do! (Yukidaruma)
mplanets=Mad Planets
mpatrolw=Moon Patrol (Williams)
mrdo=Mr. Do! (Universal)
mranger=Moon Ranger
mole=Mole Attack
moguchan=Moguchan
monwar2a=Moon War II (set 2)
monsterb=Monster Bash
mmonkey=Minky Monkey
mmaze=Marchen Maze (Japan)
mnight=Mutant Night
mnchmobl=Munch Mobile (Japan)
monymony=Money Money
mooncrsb=Moon Cresta (bootleg set 1)
mooncrs2=Moon Cresta (bootleg set 2)
mooncrst=Moon Cresta (Nichibutsu)
mooncrsg=Moon Cresta (Gremlin)
moonal2b=Moon Alien Part 2 (older version)
moonal2=Moon Alien Part 2
mooncrgx=Moon Cresta (bootleg on Galaxian hardware)
moonbase=Moon Base=
pickin=Pickin'
phozon=Phozon
pigouta=Pigout (alternate)
pigout=Pigout
phoenixa=Phoenix (Centuri)
phoenix3=Phoenix (T.P.N.)
phoenixt=Phoenix (Taito)
phoenixc=Phoenix (IRECSA
pigskin=Pigskin 621AD
piranha=Piranha
pipibibs=Pipi & Bibis / Whoopee (Japan)
pistoldm=Pistol Daimyo no Bouken (Japan)
pisces=Pisces=
pinbos=Pinbo (Strike)
pinbo=Pinbo
pipedrm=Pipe Dream (Japan)
pingpong=Ping Pong
pengo=Pengo (set 1)
peekaboo=Peek-a-Boo!
pengo2u=Pengo (set 2 not encrypted)
pengo2=Pengo (set 2)
pcktgal=Pocket Gal (Japan)
pbobble=Puzzle Bobble / Bust-A-Move (Neo-Geo)
pcktgalb=Pocket Gal (bootleg)
pcktgal2=Pocket Gal 2 (World?)
penta=Penta
phantom2=Phantom II
phantasm=Phantasm (Japan)
phoenix=Phoenix (Amstar)
phelios=Phelios (Japan)
percuss=The Percussor
pepper2=Pepper II
pgoal=Pleasure Goal / Futsal - 5 on 5 Mini Soccer
peterpak=Peter Pack-Rat
pitfall2=Pitfall II
polyplay=Poly-Play
poleps2c=Pole Position II (Atari bootleg 2)
ponpoko=Ponpoko
pompingw=Pomping World (Japan)
poleposa=Pole Position (Atari version 2)
polepos2=Pole Position II
poleps2b=Pole Position II (Atari bootleg 1)
poleps2a=Pole Position II (Atari)
ponpokov=Ponpoko (Venture Line)
popeye2=Popeye (set 2)
popeye=Popeye (set 1)
popflama=Pop Flamer (set 2)
popeyebl=Popeye (bootleg)
pooyan=Pooyan
pootan=Pootan
popbounc=Pop 'n Bounce / Gapporin
pooyans=Pooyan (Stern)
pkunwarj=Penguin-Kun Wars (Japan)
pkunwar=Penguin-Kun Wars (US)
pleiadce=Pleiads (Centuri)
pleiadbl=Pleiads (bootleg)
pitfigh3=Pit Fighter (version 3)
pitfallu=Pitfall II (not encrypted)
pkladies=Poker Ladies
pitfight=Pit Fighter (version 4)
pleiads=Pleiads (Tehkan)
polarisa=Polaris (set 2)
polaris=Polaris (set 1)
polepos1=Pole Position (Atari version 1)
polepos=Pole Position
plumppop=Plump Pop (Japan)
plotting=Plotting (World)
pnickj=Pnickies (Japan)
plusalph=Plus Alpha
oscarj1=Psycho-Nics Oscar (Japan revision 1)
oscarj0=Psycho-Nics Oscar (Japan revision 0)
outrun=Out Run (set 1)
otwalls=Off the Wall (Sente)
ordyne=Ordyne (Japan)
orbitron=Orbitron
oscarj=Psycho-Nics Oscar (Japan revision 2)
oscar=Psycho-Nics Oscar (US)
outruna=Out Run (set 2)
p47=P-47 - The Phantom Fighter (World)
ozmawars=Ozma Wars
pacgal=Pac-Gal
p47j=P-47 - The Freedom Fighter (Japan)
outzone=Out Zone
outrunb=Out Run (set 3)
overtop=Over Top
outzonep=Out Zone (bootleg)
nspiritj=Saigo no Nindou (Japan)
nspirit=Ninja Spirit
nunchaku=Nunchackun
nstocker=Night Stocker
nprincsb=Ninja Princess (bootleg?)
nprinces=Ninja Princess
nrallyx=New Rally X
nprincsu=Ninja Princess (not encrypted)
offroad=Ironman Stewart's Super Off-Road
olibochu=Oli-Boo-Chu
ohmygod=Oh My God! (Japan)
openice=2 On 2 Open Ice Challenge (rev 1.21)
omegrace=Omega Race
offtwalc=Off the Wall (2-player cocktail)
offroadt=Ironman Stewart's Super Off-Road Track Pack
ogonsiro=Ohgon no Siro (Japan)
offtwall=Off the Wall (2/3-player upright)
pacheart=Pac-Man (Hearts)
panic=Space Panic (set 1)
pangb=Pang (bootleg)
panicbom=Panic Bomber
panica=Space Panic (set 2)
pang=Pang (World)
pandoras=Pandora's Palace
pang3j=Pang! 3 (Japan)
pang3=Pang! 3 (Euro)
panicger=Space Panic (German)
pbactio2=Pinball Action (set 2)
passshtb=Passing Shot (2 Players) (bootleg)
pballoon=Pioneer Balloon
pbaction=Pinball Action (set 1)
parodius=Parodius DA! (Japan)
paperboy=Paperboy
passsht=Passing Shot (2 Players)
passht4b=Passing Shot (4 Players) (bootleg)
pacmanbl=Pac-Man (bootleg on Galaxian hardware)
pacman=PuckMan (Japan set 1)
pacmanij=Pac-Mania (Japan)
pacmania=Pac-Mania
pacland2=Pac-Land (set 2)
pacland=Pac-Land (set 1)
paclandm=Pac-Land (Midway)
pacland3=Pac-Land (set 3)
pacmanjp=PuckMan (Japan set 2)
pacplus=Pac-Man Plus
pacnpal2=Pac & Pal (older)
palamed=Palamedes (Japan)
paintrlr=Paint Roller
pacmod=Pac-Man (Midway, harder)
pacmanm=Pac-Man (Midway)
pacnpal=Pac & Pal
pacnchmp=Pac-Man & Chomp Chomp
tturfbl=Tough Turf (bootleg)
ttmahjng=T.T. Mahjong
tumblep=Tumble Pop (World)
tturfu=Tough Turf (US)
tsamura2=Samurai Nihon-ichi (set 2)
truxton=Truxton / Tatsujin
tshoot=Turkey Shoot
tsamurai=Samurai Nihon-ichi (set 1)
tumblep2=Tumble Pop (bootleg set 2)
turbofrc=Turbo Force
turbob=Turbo (encrypted set 2)
turfmast=Neo Turf Masters / Big Tournament Golf
turbotag=Turbo Tag (Prototype)
tumblepj=Tumble Pop (Japan)
tumblepb=Tumble Pop (bootleg set 1)
turboa=Turbo (encrypted set 1)
turbo=Turbo
triviag2=Trivial Pursuit (Genus II)
triviag1=Trivial Pursuit (Genus I)
triviayp=Trivial Pursuit (Young Players Edition)
triviasp=Trivial Pursuit (All Star Sports Edition)
triplep=Triple Punch
triothep=Trio The Punch - Never Forget Me... (Japan)
triviabb=Trivial Pursuit (Baby Boomer Edition)
trisport=Tri-Sports
troangel=Tropical Angel
trojanr=Trojan (Romstar)
trojanj=Tatakai no Banka (Japan)
tron2=Tron (set 2)
tron=Tron (set 1)
trog3=Trog (rev LA3 02/14/91)
trog=Trog (rev LA4 03/11/91)
trojan=Trojan (US)
trogp=Trog (prototype
turpin=Turpin
usclssic=U.S. Classic
upndown=Up'n Down
valkyrie=Legend of the Valkyrie (Japan)
usvsthem=Us vs. Them
uniwars=UniWar S
umk3r11=Ultimate Mortal Kombat 3 (rev 1.1)
uopoko=Uo Poko (Japan)
unsquad=U.N. Squadron (US)
vangrd2=Vanguard II
vaportru=Vapor Trail - Hyper Offence Formation (US)
vaportra=Vapor Trail - Hyper Offence Formation (World revision 1)
varthj=Varth - Operation Thunderstorm (Japan)
varth=Varth - Operation Thunderstorm (World)
vanguard=Vanguard (SNK)
vangrdce=Vanguard (Centuri)
vanvans=Van Van Car (Sanritsu)
vanvan=Van Van Car
twincobr=Twin Cobra (World)
twinbee=TwinBee
twineagl=Twin Eagle (Japan)
twincobu=Twin Cobra (US)
turtship=Turtle Ship
turtles=Turtles
tutankst=Tutankham (Stern)
tutankhm=Tutankham
twinspri=Twinkle Star Sprites
ufosensi=Ufo Senshi Yohko Chan
uccopsj=Undercover Cops (Japan)
umk3=Ultimate Mortal Kombat 3 (rev 1.2)
ultraman=Ultraman (Japan)
twotiger=Two Tigers
twocrude=Two Crude (US)
uccops=Undercover Cops (World)
tws96=Tecmo World Soccer '96
tmnt2pj=Teenage Mutant Ninja Turtles (2 Players Japan)
tmnt2a=Teenage Mutant Ninja Turtles - Turtles in Time (4 Players Asia)
tmntj=Teenage Mutant Ninja Turtles (4 Players Japan)
tmnt2po=Teenage Mutant Ninja Turtles (2 Players Oceania)
tmnt=Teenage Mutant Ninja Turtles (4 Players US)
tmht2p=Teenage Mutant Hero Turtles (2 Players UK)
tmnt22p=Teenage Mutant Ninja Turtles - Turtles in Time (2 Players US)
tmnt2=Teenage Mutant Ninja Turtles - Turtles in Time (4 Players US)
tndrcade=Thundercade / Twin Formation
tnzsb=The NewZealand Story (World
tnzs2=The NewZealand Story 2 (World)
todruagb=Tower of Druaga (set 2)
todruaga=Tower of Druaga (set 1)
tnk3=TNK III (US?)
tndrcadj=Tokusyu Butai UAG (Japan)
tnzs=The NewZealand Story (Japan)
tnk3j=Tank (Japan)
tigeroad=Tiger Road (US)
tigerhb2=Tiger Heli (bootleg 2)
timeplt=Time Pilot
timber=Timber
thunderx=Thunder Cross
thunderj=ThunderJaws
tigerhb1=Tiger Heli (bootleg 1)
thundfox=Thunder Fox (Japan)
timepltc=Time Pilot (Centuri)
tiptop=Tip Top
tinstar=The Tin Star
tmht=Teenage Mutant Hero Turtles (4 Players UK)
tknight=Tecmo Knight
timesold=Time Soldiers (US Rev 3)
timesol1=Time Soldiers (US Rev 1)
timscanr=Time Scanner
timetunl=Time Tunnel
toggle=Toggle
totcarnp=Total Carnage (prototype)
totcarn=Total Carnage (rev LA1 03/10/92)
tp84=Time Pilot '84 (set 1)
toypop=Toypop
toramich=Tora eno Michi (Japan)
topsecrt=Top Secret (Japan)
toryumon=Toryumon
tornbase=Tornado Baseball
tp84a=Time Pilot '84 (set 2)
travrusa=Traverse USA / Zippy Race
tranqgun=Tranquilizer Gun
trigon=Trigon (Japan)
treahunt=Treasure Hunt (Japan?)
trackflc=Track & Field (Centuri)
tpgolf=Top Player's Golf
trally=Thrash Rally
trackfld=Track & Field
tokiob=Tokio / Scramble Formation (bootleg)
tokio=Tokio / Scramble Formation
tokiu=Toki (US)
tokisens=Toki no Senshi - Chrono Soldier
toki2=Toki (set 2)
toki=Toki (set 1)
tokib=Toki (bootleg)
toki3=Toki (set 3)
tomahaw5=Tomahawk 777 (Revision 5)
topgunr=Top Gunner (US)
topgunbl=Top Gunner (bootleg)
topsecex=Top Secret (Exidy) (version 1.0)
tophuntr=Top Hunter - Roddy & Cathy
toobin=Toobin' (version 3)
tomahawk=Tomahawk 777 (Revision 1)
toobinp=Toobin' (Prototype)
toobin2=Toobin' (version 2)
varthu=Varth - Operation Thunderstorm (US)
wwfmania=WWF: Wrestlemania (rev 1.30)
wwestern=Wild Western (set 1)
xevios=Xevios
xenophob=Xenophobe
wsf=World Soccer Finals
wseries=World Series: The Season
wwester1=Wild Western (set 2)
wtennis=World Tennis
xevious=Xevious (Namco)
xsleena=Xain'd Sleena
xmultipl=X Multiply (Japan)
xybots=Xybots
xsleenab=Xain'd Sleena (bootleg)
xmen=X-Men (4 Players)
xeviousa=Xevious (Atari)
xmen6p=X-Men (6 Players)
xmen2pj=X-Men (2 Players Japan)
wof=Warriors of Fate (World)
wndrmomo=Wonder Momo
wofj=Tenchi wo Kurau II - Sekiheki no Tatakai (Japan)
wofa=Sangokushi II (Asia)
wizt=Wiz (Taito)
wiz=Wiz
wldcourt=World Court (Japan)
wjammers=Windjammers / Flying Power Disc
wonder3=Wonder 3 (Japan)
ws=World Stadium (Japan)
wrofaero=War of Aero - Project MEIOU
ws90=World Stadium '90 (Japan)
ws89=World Stadium '89 (Japan)
wotw=War of the Worlds
worldwar=World Wars (Japan)
wrestwar=Wrestle War
wow=Wizard of Wor
yamagchi=Go Go Mr. Yamaguchi / Yuke Yuke Yamaguchi-kun
zerozone=Zero Zone
zerowing=Zero Wing
zigzag2=Zig Zag (Galaxian hardware
zigzag=Zig Zag (Galaxian hardware, set 1)
zedblade=Zed Blade / Operation Ragnarok
zaxxonb=Jackson
zerotime=Zero Time
zektor=Zektor
zingzip=Zing Zing Zip
zwackery=Zwackery
zookeep3=Zoo Keeper (set 3)
zzyzzyxx=Zzyzzyxx (set 1)
zzyzzyx2=Zzyzzyxx (set 2)
zodiack=Zodiack
zoar=Zoar
zookeep2=Zoo Keeper (set 2)
zookeep=Zoo Keeper (set 1)
yard=10 Yard Fight
yankeedo=Yankee DO!
yiear=Yie Ar Kung-Fu (set 1)
yesnoj=Yes/No Sinri Tokimeki Chart
yamato2=Yamato (set 2)
yamato=Yamato (set 1)
yanchamr=Kaiketsu Yanchamaru (Japan)
yamyam=Yam! Yam!?
yiear2=Yie Ar Kung-Fu (set 2)
zarzon=Zarzon
yuyugogo=Yuuyu no Quiz de GO!GO! (Japan)
zaxxon2=Zaxxon (set 2)
zaxxon=Zaxxon (set 1)
yosakdon=Yosaku To Donbee (bootleg)
yokaidko=Yokai Douchuuki (Japan old version)
youma=Youma Ninpou Chou (Japan)
youkaidk=Yokai Douchuuki (Japan new version)
vsyard2=10 Yard Fight (Vs. version
vsyard=10 Yard Fight (Vs. version 11/05/84)
vulgus=Vulgus (set 1)
vulcan=Vulcan Venture
vindictr=Vindicators
vindctr2=Vindicators Part II
viper=Viper
viofight=Violence Fight (World)
vulgus2=Vulgus (set 2)
wardnerj=Wardna no Mori (Japan)
wardner=Wardner (World)
warofbug=War of the Bugs
warlord=Warlords
wacko=Wacko
vulgusj=Vulgus (Japan?)
wanted=Wanted
wakuwak7=Waku Waku 7
venture=Venture (version 5 set 1)
vendettj=Crime Fighters 2 (Japan)
venture4=Venture (version 4)
venture2=Venture (version 5 set 2)
vastar2=Vastar (set 2)
vastar=Vastar (set 1)
vendetta=Vendetta (Asia set 1)
vendett2=Vendetta (Asia set 2)
venus=Venus
vigilant=Vigilante (World)
viewpoin=Viewpoint
vigilntu=Vigilante (US)
vigilntj=Vigilante (Japan)
victorba=Victor Banana
vfive=V-Five (Japan)
victroad=Victory Road
victory=Victory
warpwar2=Warp Warp (Rock-ola set 2)
wexpress=Western Express (World?)
wexpresb=Western Express (bootleg)
wh2=World Heroes 2
wh1=World Heroes
wc90b=Euro League
wc90=World Cup 90
weststry=West Story
wecleman=WEC Le Mans 24
wh2j=World Heroes 2 Jet
willowj=Willow (Japan
willow=Willow (Japan, English)
wiseguy=Wise Guy
wiping=Wiping
whoopee=Whoopee (Japan) / Pipi & Bibis (World)
whodunit=Who Dunit (version 8.0)
wildfang=Wild Fang
whp=World Heroes Perfect
wb3bl=Wonder Boy III - Monster Lair (bootleg)
wb3a=Wonder Boy III - Monster Lair (set 2)
wbml=Wonder Boy in Monster Land
wbdeluxe=Wonder Boy Deluxe
warpwarr=Warp Warp (Rock-ola set 1)
warpwarp=Warp & Warp
wb3=Wonder Boy III - Monster Lair (set 1)
warrior=Warrior
wbmlj=Wonder Boy in Monster Land (Japan set 1)
wboy4=Wonder Boy (set 4)
wboy3=Wonder Boy (set 3)
wboyu=Wonder Boy (not encrypted)
wboy4u=Wonder Boy (set 4 not encrypted)
wbmlju=Wonder Boy in Monster Land (Japan not encrypted)
wbmlj2=Wonder Boy in Monster Land (Japan set 2)
wboy2=Wonder Boy (set 2)
wboy=Wonder Boy (set 1)
spaceint=Space Intruder
spacefev=Space Fever (color)
spaceod=Space Odyssey
spaceinv=Space Invasion
spacefb=Space Firebird (Nintendo)
spacedx=Space Invaders DX (Japan)
spacefbg=Space Firebird (Gremlin)
spacefbb=Space Firebird (bootleg)
spaceph=Space Phantoms
spacezap=Space Zap
spacewr3=Space War Part 3
spacfury=Space Fury (revision C)
spacfura=Space Fury (revision A)
spaceskr=Space Seeker
spaceplt=Space Pilot
spacewar=Space Wars
spacetrk=Space Trek (upright)
solomon=Solomon's Key (Japan)
solfigtr=Solitary Fighter (World)
sonicwi2=Aero Fighters 2 / Sonic Wings 2
sonicwi=Sonic Wings (Japan)
solarq=Solar Quest
solarfox=Solar Fox
solfight=Solar Fight
solarwar=Solar Warrior
sonicwi3=Aero Fighters 3 / Sonic Wings 3
spacduel=Space Duel
spacbatt=Space Battle
spacebrd=Space Bird (bootleg)
spaceatt=Space Attack II
sonson=Son Son
sonofphx=Son of Phoenix
soukobdx=Souko Ban Deluxe (Japan)
sos=SOS
spang=Super Pang (World)
spinmast=Spinmaster / Miracle Adventure
spinlbru=Spinal Breakers (US)
splat=Splat!
splash=Splash!
spiker=Spiker
spiero=Super Pierrot (Japan)
spinlbrk=Spinal Breakers (World)
spinlbrj=Spinal Breakers (Japan)
splatter=Splatter House (Japan)
sprint1=Sprint 1
springer=Springer
sptrekct=Space Trek (cocktail)
sprint2=Sprint 2
spnchout=Super Punch-Out!!
spnchotj=Super Punch-Out!! (Japan)
spool3i=Super Pool III (I-Vics)
spool3=Super Pool III (World?)
spcewars=Space War (Sanritsu)
spcewarl=Space War (Leijac)
spdcoin=Speed Coin (prototype)
spclaser=Space Laser
spartanx=Spartan X (Japan)
sparkz=Sparkz (prototype)
spcenctr=Space Encounters
spceking=Space King
speakres=Speak & Rescue
spelunkr=Spelunker
spelunk2=Spelunker II
spiders2=Spiders (set 2)
spiders=Spiders (set 1)
spectar1=Spectar (revision 1?)
spectar=Spectar (revision 3)
speedfrk=Speed Freak
speedbal=Speed Ball
simpsn2p=The Simpsons (2 Players)
simps2pj=The Simpsons (2 Players Japan)
sindbadm=Sindbad Mystery
simpsons=The Simpsons (4 Players)
silkworm=Silkworm (set 1)
silentd=Silent Dragon (World)
silvland=Silver Land
silkwrm2=Silkworm (set 2)
sinista1=Sinistar (prototype version)
sisv2=Space Invaders (SV Version 2)
sisv=Space Invaders (SV Version)
skingam2=The Irem Skins Game (US set 2)
sitv=Space Invaders (TV Version)
sinistar=Sinistar (revision 3)
sinista2=Sinistar (revision 2)
sinvzen=Super Invaders (Zenitone-Microsec)
sinvemag=Super Invaders (EMAG)
shuuz=Shuuz (version 8.0)
shuffle=Shuffleboard
sichuan2=Sichuan II (hack?) (set 1)
shuuz2=Shuuz (version 7.1)
shootout=Shoot Out (US)
shootouj=Shoot Out (Japan)
shtngmst=Shooting Master
showdown=Showdown (version 5.0)
sichuana=Sichuan II (hack ?) (set 2)
sidepctb=Side Pocket (bootleg)
sidepckt=Side Pocket (World)
sidetrac=Side Track
sidepctj=Side Pocket (Japan)
sidearjp=Side Arms - Hyper Dyne (Japan)
sicv=Space Invaders (CV Version)
sidearms=Side Arms - Hyper Dyne (World)
sidearmr=Side Arms - Hyper Dyne (US)
skingame=The Irem Skins Game (US set 1)
smooncrs=Super Moon Cresta
smashtv6=Smash T.V. (rev 6.00)
snakjack=Snacks'n Jaxson
snakepit=Snake Pit
smashtv=Smash T.V. (rev 8.00)
slyspy2=Sly Spy (US revision 2)
smashtv5=Smash T.V. (rev 5.00)
smashtv4=Smash T.V. (rev 4.00)
snapjack=Snap Jack
snowbros=Snow Bros. - Nick & Tom (set 1)
snowbroj=Snow Bros. - Nick & Tom (Japan)
soccer=Atari Soccer
socbrawl=Soccer Brawl
snowbro2=Snow Bros. 2 - With New Elves
sngkace=Sengoku Ace (Japan)
snowbrob=Snow Bros. - Nick & Tom (set 3)
snowbroa=Snow Bros. - Nick & Tom (set 2)
skykid=Sky Kid
skydiver=Sky Diver
skykiddx=Sky Kid Deluxe (set 1)
skykiddo=Sky Kid Deluxe (set 2)
skullxbo=Skull & Crossbones (set 1)
skullxb2=Skull & Crossbones (set 2)
skychut=Sky Chuter
skyadvnt=Sky Adventure (US)
skylancr=Sky Lancer
slapbtjp=Slap Fight (Japan bootleg)
slammast=Saturday Night Slam Masters (World)
slyspy=Sly Spy (US revision 3)
slapbtuk=Slap Fight (English bootleg)
skysoldr=Sky Soldiers (US)
skyshark=Sky Shark (US)
skywolf2=Sky Wolf (set 2)
skywolf=Sky Wolf (set 1)
spy=S.P.Y. - Special Project Y (US)
sws92=Super World Stadium '92 (Japan)
swimmera=Swimmer (set 2)
sxevious=Super Xevious
sws93=Super World Stadium '93 (Japan)
swarm=Swarm
svolly91=Super Volley '91 (Japan)
swimmer=Swimmer (set 1)
swat=SWAT
szaxxon=Super Zaxxon
tankfrce=Tank Force (US)
tankbatt=Tank Battalion
tapper=Tapper (Budweiser)
tankfrcj=Tank Force (Japan)
tagteam=Tag Team Wrestling
tacscan=Tac/Scan
tailg=Tailgunner
tail2nos=Tail to Nose - Great Championship
superpac=Super Pac-Man
superman=Superman
superqix=Super Qix
superpcm=Super Pac-Man (Midway)
supbtimj=Super Burger Time (Japan)
supbtime=Super Burger Time (World)
superinv=Super Invaders
superg=Super Galaxians
superspy=The Super Spy
sutapper=Tapper (Suntory)
surpratk=Surprise Attack (Japan)
svolleyk=Super Volleyball (Korea)
svolley=Super Volleyball (Japan)
suprmatk=Super Missile Attack
suprloco=Super Locomotive
suprmous=Super Mouse
suprmou2=Funny Mouse (bootleg?)
tappera=Tapper (alternate)
tetrisa=Tetris (Sega Set 2)
tetris=Tetris (Sega Set 1)
tetrist=Tetris (Japan, B-System)
tetrisbl=Tetris (Sega bootleg)
terracre=Terra Cresta (YM3526 set 1)
terracrb=Terra Cresta (YM3526 set 2)
terrafu=Terra Force (US)
terraf=Terra Force
theend=The End
thndblst=Thunder Blaster (Japan)
thepit=The Pit
thndrx2=Thunder Cross II (Japan)
thnderxj=Thunder Cross (Japan)
theglob=The Glob
theends=The End (Stern)
thehustl=The Hustler (Japan version M)
thehustj=The Hustler (Japan version J)
teamqb=John Elway's Team Quarterback
tdfeverj=TouchDown Fever (Japan)
teddybb=TeddyBoy Blues
teamqb2=John Elway's Team Quarterback (set 2)
tazmani2=Tazz-Mania (Strategy X hardware)
targ=Targ
tdfever=TouchDown Fever
tazmania=Tazz-Mania (Scramble hardware)
teedoff=Tee'd Off
temptube=Tempest Tubes
tempest2=Tempest (rev 2)
terracra=Terra Cresta (YM2203)
term2=Terminator 2 - Judgment Day (rev LA3 03/27/92)
tekipaki=Teki Paki
tehkanwc=Tehkan World Cup
tempest1=Tempest (rev 1)
tempest=Tempest (rev 3)
ssrdrjbd=Sunset Riders (Japan 2 Players ver. JBD)
ssrdrebd=Sunset Riders (World 2 Players ver. EBD)
ssrdrubc=Sunset Riders (US 2 Players ver. UBC)
ssrdruac=Sunset Riders (US 4 Players ver. UAC)
ssprint=Super Sprint
sspaceat=Space Attack (upright)
ssrdrebc=Sunset Riders (World 2 Players ver. EBC)
ssrdrabd=Sunset Riders (Asia 2 Players ver. ABD)
ssrdruda=Sunset Riders (US 4 Players ver. UDA)
stakwin2=Stakes Winner 2
stakwin=Stakes Winner / Stakes Winner - GI kinzen seihae no michi
starcas1=Star Castle (older)
starcas=Star Castle (version 3)
sstingry=Super Stingray
ssriders=Sunset Riders (World 4 Players ver. EAC)
stadhero=Stadium Hero (Japan)
stactics=Space Tactics
srdarwin=Super Real Darwin (Japan)
sqixbl=Super Qix (bootleg)
srumbler=The Speed Rumbler (set 1)
srdmissn=S.R.D. Mission
spyhunt=Spy Hunter
spyhnt2a=Spy Hunter 2 (rev 1)
sqbert=Faster, Harder, More Challenging Q*bert (prototype)
spyhunt2=Spy Hunter 2 (rev 2)
srumblr2=The Speed Rumbler (set 2)
ssozumo=Syusse Oozumou (Japan)
ssideki4=The Ultimate 11 / Tokuten Ou - Honoo no Libero
sspacatc=Space Attack (cocktail)
sspacat2=Space Attack (upright
ssideki=Super Sidekicks / Tokuten Ou
ssi=Super Space Invaders '91 (World)
ssideki3=Super Sidekicks 3 - The Next Glory / Tokuten Ou 3 - eikoue no michi
ssideki2=Super Sidekicks 2 - The World Championship / Tokuten Ou 2 - real fight football
starcrus=Star Cruiser
streets1=Street Smart (US version 1)
streakng=Streaking
streetsm=Street Smart (US version 2)
streetsj=Street Smart (Japan version 1)
stratgyx=Strategy X
stratgys=Strategy X (Stern)
stratvxb=Stratovox (bootleg)
stratvox=Stratovox
strhoop=Street Hoop / Street Slam / Dunk Dream
subs=Subs
strkzone=Strike Zone
sundance=Sundance
sucasino=Super Casino
striderj=Strider Hiryu (Japan set 1)
strider=Strider (US)
strkforc=Strike Force (rev 1 02/25/91)
stridrja=Strider Hiryu (Japan set 2)
starjack=Star Jacker (Sega)
starhawk=Star Hawk
startrek=Star Trek
starjacs=Star Jacker (Stern)
starforc=Star Force
starfire=Star Fire
stargate=Stargate
starfore=Star Force (encrypted)
starw=Star Wars
stocker=Stocker
stinger=Stinger
storming=Storming Party / Riku Kai Kuu Saizensen
stoneage=Stoneage
starwars=Star Wars (rev 2)
starwar1=Star Wars (rev 1)
stfight=Street Fight (Germany)
stdragon=Saint Dragon
mhavocp=Major Havoc (prototype)
cop01a=Cop 01 (set 2)
cop01=Cop 01 (set 1)
cosmica=Cosmic Alien
copsnrob=Cops'n Robbers
contraj=Contra (Japan)
contrab=Contra (US bootleg)
cookrace=Cook Race
contrajb=Contra (Japan bootleg)
cosmica2=Cosmic Alien (older)
cracksht=Crackshot (version 2.0)
cottong=Cotocoto Cottong
crater=Crater Raider
crash=Crash
cosmicmo=Cosmic Monsters
cosmicg=Cosmic Guerilla
cosmognj=Cosmo Gang the Video (Japan)
cosmogng=Cosmo Gang the Video (US)
combasc=Combat School (joystick)
colony7a=Colony 7 (set 2)
combascj=Combat School (Japan trackball)
combascb=Combat School (bootleg)
cobracmj=Cobra-Command (Japan)
cninjau=Caveman Ninja (US)
colony7=Colony 7 (set 1)
cobracom=Cobra-Command (World revision 5)
combasct=Combat School (trackball)
comotion=Comotion
commsega=Commando (Sega)
contra=Contra (US)
congo=Congo Bongo
commandj=Senjo no Ookami
combat=Combat (version 3.0)
commandu=Commando (US)
commando=Commando (World)
crazyblk=Crazy Blocks
cutieq=Cutie Q
curvebal=Curve Ball
cworld2j=Capcom World 2 (Japan)
cworld=Capcom World (Japan)
ctribe=The Combatribes (US)
csprint=Championship Sprint
cuebrick=Cuebrick
ctribeb=The Combatribes (bootleg)
cyberb2p=Cyberball 2072 (2 player)
dakkochn=DakkoChan Jansoh
dairesya=Dai Ressya Goutou (Japan)
dangar2=Dangar - Ufo Robo (9/26/1986)
dangar=Dangar - Ufo Robo (12/1/1986)
cyberbal=Cyberball (Version 4)
cyberba2=Cyberball (Version 2)
cyberlip=Cyber-Lip
cyberbt=Tournament Cyberball 2072
crimecu=Crime City (US)
crimecj=Crime City (Japan)
crimfgt2=Crime Fighters (World 2 Players)
crimfght=Crime Fighters (US 4 players)
crbalon2=Crazy Balloon (set 2)
crazycop=Crazy Cop (Japan)
crimec=Crime City (World)
crbaloon=Crazy Balloon (set 1)
crimfgtj=Crime Fighters (Japan 2 Players)
crush3=Crush Roller (Kural - bootleg?)
crush2=Crush Roller (Kural Esco - bootleg?)
csilver=Captain Silver (Japan)
cshift=Chicken Shift
crsword=Crossed Swords
crossbow=Crossbow (version 2.0)
crush=Crush Roller (Kural Samno)
cruisin=Cruisin
centipd2=Centipede (revision 2)
centipb2=Centipede (bootleg set 2)
centiped=Centipede (revision 3)
centipdb=Centipede (bootleg set 1)
cclimber=Crazy Climber (US)
cchasm1=Cosmic Chasm (set 2)
cclimbrj=Crazy Climber (Japan)
cclimbr2=Crazy Climber 2 (Japan)
cerberus=Cerberus
champwrj=Champion Wrestler (Japan)
champwr=Champion Wrestler (World)
changes=Changes
champwru=Champion Wrestler (US)
champbas=Champion Baseball
challeng=Challenger
champbbj=Champion Baseball (Japan)
champbb2=Champion Baseball II
cavenger=Cosmic Avenger
carnvckt=Carnival (cocktail)
cawingj=U.S. Navy (Japan)
cawing=Carrier Air Wing (World)
captcomu=Captain Commando (US)
captcomm=Captain Commando (World)
carnival=Carnival (upright)
caractn=Car Action
cbasebal=Capcom Baseball (Japan)
ccboot=Crazy Climber (bootleg set 1)
ccastles=Crystal Castles (set 1)
cchasm=Cosmic Chasm (set 1)
ccboot2=Crazy Climber (bootleg set 2)
cbusterj=Crude Buster (Japan)
cbuster=Crude Buster (World FX version)
ccastle2=Crystal Castles (set 2)
cbusterw=Crude Buster (World FU version)
checkmaj=Checkman (Japan)
ckonga=Crazy Kong (set 2)
ckong=Crazy Kong (set 1)
ckongjeu=Crazy Kong (Jeutel bootleg)
ckongalc=Crazy Kong (Alca bootleg)
cischeat=Cisco Heat
circusce=Circus Charlie (Centuri
citycona=City Connection (set 2)
citycon=City Connection (set 1)
ckongo=Crazy Kong (Orca bootleg)
clowns=Clowns
cloud9=Cloud 9 (prototype)
cninja0=Caveman Ninja (World revision 0)
cninja=Caveman Ninja (World revision 3)
claypign=Clay Pigeon (version 2.0)
ckongs=Crazy Kong (Scramble hardware)
cloak=Cloak & Dagger
clbowl=Coors Light Bowling
cheyenne=Cheyenne (version 1.0)
chelnovj=Chelnov - Atomic Runner (Japan)
chiller=Chiller (version 3.0)
chikij=Chiki Chiki Boys (Japan)
checkmat=Checkmate
checkman=Checkman
chelnov=Chelnov - Atomic Runner (US)
cheekyms=Cheeky Mouse
chopper=Chopper I
circusc=Circus Charlie
circus=Circus
circuscc=Circus Charlie (Centuri)
circusc2=Circus Charlie (no level select)
chplftb=Choplifter (alternate)
chplft=Choplifter
chukatai=Chuka Taisen (Japan)
chplftbl=Choplifter (bootleg)
downtown=DownTown
dowild=Mr. Do's Wild Ride
dremshpr=Dream Shopper
dplay=Double Play
dotrone=Discs of Tron (Environmental)
dotron=Discs of Tron (Upright)
douni=Mr. Do vs. Unicorns
doubledr=Double Dragon (Neo-Geo)
drgnbstr=Dragon Buster
dsaber=Dragon Saber
drtoppel=Dr. Toppel's Tankentai (Japan)
dsoccr94=Dream Soccer '94
dsaberj=Dragon Saber (Japan)
drgnunit=Dragon Unit / Castle of Dragon
drgninja=Dragonninja (Japan)
driveout=Drive Out
driftout=Drift Out (Japan)
dogosoke=Dogou Souken
dogfight=Dog Fight
dogyuun=Dogyuun
dogpatch=Dog Patch
dkongjr=Donkey Kong Junior (US)
dkongjpo=Donkey Kong (Japan set 2)
docastle=Mr. Do's Castle (set 1)
docastl2=Mr. Do's Castle (set 2)
dokaben=Dokaben (Japan)
dorunrun=Do! Run Run (set 1)
dorunruc=Do! Run Run (Do's Castle hardware)
dotrikun=Dottori Kun (new version)
dotriku2=Dottori Kun (old version)
dominos=Dominos
domino=Domino Man
dorunru2=Do! Run Run (set 2)
dondokod=Don Doko Don (Japan)
dspirit=Dragon Spirit (new version)
empcity=Empire City: 1931 (bootleg?)
elim4=Eliminator (4 Players)
endurob2=Enduro Racer (bootleg set 2)
empcityj=Empire City: 1931 (Japan)
elevator=Elevator Action
elevatob=Elevator Action (bootleg)
elim2a=Eliminator (2 Players
elim2=Eliminator (2 Players, set 1)
endurobl=Enduro Racer (bootleg set 1)
espiale=Espial (Europe)
espial=Espial (US?)
eswat=E-Swat
esprade=ESP Ra.De. (Japan)
eprom=Escape from the Planet of the Robot Monsters (set 1)
enduror=Enduro Racer
esb=The Empire Strikes Back
eprom2=Escape from the Planet of the Robot Monsters (set 2)
dynduke=Dynamite Duke
dygera=Dyger (set 2)
eagle=Eagle (set 1)
dzigzag=Zig Zag (Dig Dug hardware)
dumpmtmt=Dump Matsumoto (Japan)
dspirito=Dragon Spirit (old version)
dyger=Dyger (set 1)
dwj=Tenchi wo Kurau (Japan)
eagle2=Eagle (set 2)
einnings=Extra Innings
eightman=Eight Man
elecyoyo=The Electric Yo-Yo (set 1)
elecyoy2=The Electric Yo-Yo (set 2)
ebases=Extra Bases
earthinv=Super Earth Invasion
eggs=Eggs
edf=Earth Defense Force
ddribble=Double Dribble
ddragonu=Double Dragon (US)
deadconj=Dead Connection (Japan)
dduxbl=Dynamite Dux (bootleg)
ddragon2=Double Dragon II - The Revenge
ddragon=Double Dragon (Japan)
ddragonb=Double Dragon (bootleg)
ddragon3=Double Dragon 3 - The Rosetta Stone
deadconx=Dead Connection (World)
defendw=Defender (White label)
defendg=Defender (Green label)
demonwld=Demon's World / Horror Story
demon=Demon
defcmnd=Defense Command (set 1)
deadeye=Dead Eye
defender=Defender (Red label)
defence=Defence Command
darksea1=Dark Seal (World revision 1)
darkplnt=Dark Planet
darkseal=Dark Seal (World revision 3)
darkseaj=Dark Seal (Japan)
dangerz=Danger Zone
dangarb=Dangar - Ufo Robo (bootleg)
darkadv=Dark Adventure
dangseed=Dangerous Seed (Japan)
darwin=Darwin 4078 (Japan)
ddayc=D-Day (Centuri)
dday=D-Day
ddrago3b=Double Dragon 3 - The Rosetta Stone (bootleg)
ddonpach=Dodonpachi (Japan)
dblplay=Super Baseball Double Play Home Run Derby
dbldyn=The Double Dynamites
dcon=D-Con
dbreed=Dragon Breed
depthch=Depthcharge
dinorex=Dino Rex (World)
dinoj=Cadillacs Kyouryuu-Shinseiki (Japan)
dinorexu=Dino Rex (US)
dinorexj=Dino Rex (Japan)
digdugb=Dig Dug (set 2)
digdugat=Dig Dug (Atari)
dino=Cadillacs and Dinosaurs (World)
digger=Digger
disco=Disco No.1
dkong3=Donkey Kong 3 (US)
dkong=Donkey Kong (US)
dkongjp=Donkey Kong (Japan set 1)
dkong3j=Donkey Kong 3 (Japan)
dkjrbl=Donkey Kong Junior (bootleg?)
dkgensan=Daiku no Gensan (Japan)
dkngjrjp=Donkey Kong Jr. (Original Japanese)
dkjrjp=Donkey Kong Junior (Japan)
devilfsg=Devil Fish (Galaxian hardware
detatwin=Detana!! Twin Bee (Japan)
devilw=Devil World
devilfsh=Devil Fish
destderb=Demolition Derby
desertgu=Desert Gun
desterth=Destination Earth
destderm=Demolition Derby (2-Player Mono Board Version)
devstor2=Devastators (version X)
digdug=Dig Dug (set 1)
diamond=Diamond Run
digdug2a=Dig Dug II (set 2)
digdug2=Dig Dug II (set 1)
devstors=Devastators (version Z)
devstor3=Devastators (version V)
dfeveron=Dangun Feveron (Japan)
devzone=Devil Zone
captcomj=Captain Commando (Japan)
armorcar=Armored Car (set 1)
armorca2=Armored Car (set 2)
ashura=Ashura Blaster (Japan)
armwrest=Arm Wrestling
arknoidu=Arkanoid (US)
arknoidj=Arkanoid (Japan)
armora=Armor Attack
armedf=Armed Formation
ashurau=Ashura Blaster (US)
astdelux=Asteroids Deluxe (rev 2)
astdelu1=Asteroids Deluxe (rev 1)
asteroib=Asteroids (bootleg on Lunar Lander hardware)
asteroi1=Asteroids (rev 1)
assault=Assault
aso=ASO - Armored Scrum Object
assaultp=Assault Plus (Japan)
assaultj=Assault (Japan)
archrivl=Arch Rivals (rev 4.0)
archriv2=Arch Rivals (rev 2.0)
ark2jp=Arkanoid - Revenge of DOH (Japan)
area88=Area 88 (Japan)
arabiana=Arabian (Atari)
arabian=Arabian
arcadecl=Arcade Classics (prototype)
arbalest=Arbalester
ark2us=Arkanoid - Revenge of DOH (US)
arkatour=Tournament Arkanoid (US)
arkatayt=Arkanoid (Tayto bootleg
arkbloc2=Block (Game Corporation bootleg)
arkbl2=Arkanoid (Japanese bootleg Set 2)
arkanoi2=Arkanoid - Revenge of DOH (World)
arkangc=Arkanoid (Game Corporation bootleg)
arkarea=Ark Area
arkanoid=Arkanoid (World)
asteroid=Asteroids (rev 2)
atlantis=Battle of Atlantis (set 1)
athena=Athena
atomicp=Atomic Point
atlants2=Battle of Atlantis (set 2)
atetris=Tetris (set 1)
atetcktl=Tetris (Cocktail set 1)
atetrisb=Tetris (bootleg)
atetrisa=Tetris (set 2)
aurail=Aurail (set 1)
aztarac=Aztarac
avspirit=Avenging Spirit
baddudes=Bad Dudes vs. Dragonninja (US)
azurian=Azurian Attack
avalnche=Avalanche
auraila=Aurail (set 2)
avengers=Avengers (set 1)
avenger2=Avengers (set 2)
astrob1=Astro Blaster (version 1)
astrob=Astro Blaster (version 3)
astrof=Astro Fighter (set 1)
astrob2=Astro Blaster (version 2)
astorm=Alien Storm
astinvad=Astro Invader
astormbl=Alien Storm (bootleg)
astorm2p=Alien Storm (2 Player)
astrof2=Astro Fighter (set 2)
ataxxa=Ataxx (set 2)
ataxx=Ataxx (set 1)
atetckt2=Tetris (Cocktail set 2)
ataxxj=Ataxx (Japan)
atarifb=Atari Football (revision 2)
astrof3=Astro Fighter (set 3)
atarifb4=Atari Football (4 players)
atarifb1=Atari Football (revision 1)
99lstwra='99 The Last War (alternate)
99lstwar='99 The Last War
abaseb=Atari Baseball (set 1)
aafbd2p=All American Football (rev D
720b=720 Degrees (set 2)
720=720 Degrees (set 1)
88games='88 Games
800fath=800 Fathoms
abaseb2=Atari Baseball (set 2)
aerofgtc=Aero Fighters (Turbo Force hardware set 2)
aerofgtb=Aero Fighters (Turbo Force hardware set 1)
airduel=Air Duel (Japan)
airbustr=Air Buster (Japan)
actfancj=Act-Fancer Cybernetick Hyper Weapon (Japan revision 1)
actfanc1=Act-Fancer Cybernetick Hyper Weapon (World revision 1)
aerofgt=Aero Fighters
actfancr=Act-Fancer Cybernetick Hyper Weapon (World revision 2)
1941=1941 - Counter Attack (World)
1941j=1941 - Counter Attack (Japan)
1942=1942 (set 1)
1942a=1942 (set 2)
1942b=1942 (set 3)
1943=1943 - The Battle of Midway (US)
1943j=1943 - The Battle of Midway (Japan)
1943kai=1943 Kai
005=005
3wonders=Three Wonders (US)
3stooges=Three Stooges
600=600
4dwarrio=4-D Warriors
2020bbh=2020 Super Baseball (set 2)
2020bb=2020 Super Baseball (set 1)
3countb=3 Count Bout / Fire Suplex
280zzzap=Datsun 280 Zzzap
airwolf=Air Wolf
amidars=Amidar (Scramble hardware)
amidaro=Amidar (Olympia)
amigo=Amigo
amidaru=Amidar (Stern)
altbeast=Altered Beast (Version 1)
altbeas2=Altered Beast (Version 2)
amidar=Amidar
ambush=Ambush
androdun=Andro Dunos
apb=APB - All Points Bulletin (set 1)
aof3=Art of Fighting 3 - The Path of the Warrior / Art of Fighting - Ryuuko no Ken Gaiden
appoooh=Appoooh
apb2=APB - All Points Bulletin (set 2)
aodk=Aggressors of Dark Kombat / Tsuukai GANGAN Koushinkyoku
anteater=Anteater
aof2=Art of Fighting 2 / Ryuuko no Ken 2
aof=Art of Fighting / Ryuuko no Ken
aliens=Aliens (World set 1)
alieninv=Alien Invasion Part II
aliensj=Aliens (Japan)
aliens2=Aliens (World set 2)
ajaxj=Ajax (Japan)
ajax=Ajax
alexkidd=Alex Kidd (set 1)
alexkida=Alex Kidd (set 2)
aliensu=Aliens (US)
alpham2=Alpha Mission II / ASO II - Last Guardian
alleymas=Alley Master
alpinea=Alpine Ski (set 2)
alpine=Alpine Ski (set 1)
aliensyb=Alien Syndrome (set 3)
aliensya=Alien Syndrome (set 2)
aliensyn=Alien Syndrome (set 1)
aliensyj=Alien Syndrome (Japan)
boscoo=Bosconian (old version)
boscomdo=Bosconian (Midway
bottom9=Bottom of the Ninth (version T)
boscoo2=Bosconian (older version)
boothill=Boot Hill
bootcamp=Boot Camp
boscomd=Bosconian (Midway
bosco=Bosconian (new version)
bottom9n=Bottom of the Ninth (version N)
breakrev=Breakers Revenge
breakers=Breakers
brix=Brix
breywood=Breywood (Japan revision 2)
bowler=4 Player Bowling
bouldash=Boulder Dash / Boulder Dash Part 2 (World)
boxingb=Boxing Bugs
bowlrama=Bowl-O-Rama
blswhstl=Bells & Whistles
blstroid=Blasteroids (version 4)
blueprnt=Blue Print (Midway)
blueprnj=Blue Print (Jaleco)
bloodbro=Blood Bros.
blockout=Block Out (set 1)
blstroi2=Blasteroids (version 2)
blsthead=Blasteroids (with heads)
blueshrk=Blue Shark
bombbee=Bomb Bee
bogeyman=Bogey Manor
bombjack=Bomb Jack (set 1)
bombjac2=Bomb Jack (set 2)
bnj=Bump 'n' Jump
bmaster=Blade Master (World)
bodyslam=Body Slam
boblbobl=Bobble Bobble
brkthru=Break Thru (US)
cabal=Cabal (US set 1)
bzone2=Battle Zone (set 2)
cabalbl=Cabal (bootleg)
cabal2=Cabal (US set 2)
burningh=Burning Fight (set 2)
burningf=Burning Fight (set 1)
bzone=Battle Zone (set 1)
bwidow=Black Widow
cachat=Cachat (Japan)
canyon=Canyon Bomber
canbprot=Canyon Bomber (prototype)
capbowl2=Capcom Bowling (set 2)
capbowl=Capcom Bowling (set 1)
calipso=Calipso
calibr50=Caliber 50
cameltry=Camel Try (Japan)
cameltru=Camel Try (US)
bstars2=Baseball Stars 2
bstars=Baseball Stars Professional
btime2=Burger Time (Data East set 2)
btime=Burger Time (Data East set 1)
brubber=Burnin' Rubber
brkthruj=Kyohkoh-Toppa (Japan)
bsktball=Basketball
brutforc=Brute Force
btimem=Burger Time (Midway)
bublbobr=Bubble Bobble (US with mode select)
bublbobl=Bubble Bobble
burnforc=Burning Force (Japan)
bullfgtj=The Tougyuu (Japan)
bubbles=Bubbles
btlfield=Battle Field (Japan)
bubbobr1=Bubble Bobble (US)
bubblesr=Bubbles (Solid Red label)
bayrouta=Bay Route (set 2)
battroad=The Battle-Road
bayrtbl1=Bay Route (bootleg set 1)
bayroute=Bay Route (set 1)
battlera=Battle Rangers (World)
battlane=Battle Lane Vol. 5 (set 1)
battlnts=Battlantis
battlntj=Battlantis (Japan)
bayrtbl2=Bay Route (bootleg set 2)
berlwalt=The Berlin Wall (set 2)
berlwall=The Berlin Wall (set 1)
bermudaj=Bermuda Triangle (Japan)
bermudaa=Bermuda Triangle (US early version)
bchopper=Battle Chopper
bbros=Buster Bros (US)
berabohm=Beraboh Man (Japan)
beastf=Beastie Feastie
bakatono=Bakatonosama Mahjong Manyuki
bagnard=Le Bagnard
baluba=Baluba-louk no Densetsu
ballbomb=Balloon Bomber
bagman=Bagman
badlands=Bad Lands
bagmans2=Bagman (Stern set 2)
bagmans=Bagman (Stern set 1)
bandido=Bandido
batsugun=Batsugun
batman=Batman
battlan3=Battle Lane Vol. 5 (set 3)
battlan2=Battle Lane Vol. 5 (set 2)
baraduke=Baraduke
bankp=Bank Panic
basebal2=Baseball The Season II
barrier=Barrier
bermudat=Bermuda Triangle (US)
bldwolf=Bloody Wolf (US)
blckout2=Block Out (set 2)
blkdrgon=Black Dragon
blkdrgnb=Black Dragon (bootleg)
blazer=Blazer (Japan)
blastoff=Blast Off (Japan)
blckgalb=Block Gal (bootleg)
blazstar=Blazing Star
blkhole=Black Hole
blockgal=Block Gal
blocken=Blocken (Japan)
blockj=Block Block (Japan)
blockhl=Block Hole
block=Block Block (World)
blktiger=Black Tiger
blockbl=Block Block (bootleg)
blockade=Blockade
bionicc=Bionic Commando (US set 1)
bioatack=Bio Attack
bjourney=Blue's Journey / Raguy
bionicc2=Bionic Commando (US set 2)
berzerk1=Berzerk (set 2)
berzerk=Berzerk (set 1)
billiard=The Billiards
bigprowr=The Big Pro Wrestling!
bjtwin=Bombjack Twin
blasted=Blasted
blandia=Blandia [Prototype]
blasto=Blasto
blaster=Blaster
bktigerb=Black Tiger (bootleg)
bking2=Birdie King 2
bladstle=Blades of Steel (version E)
bladestl=Blades of Steel (version T)
karatedo=Karate Dou (Japan)
karatblz=Karate Blazers (World?)
karnov=Karnov (US)
karatevs=Taisen Karate Dou (Japan VS version)
kangaroo=Kangaroo
kangarob=Kangaroo (bootleg)
karatblu=Karate Blazers (US)
kaos=Kaos
karnovj=Karnov (Japan)
kicka=Kick (cocktail)
kick=Kick (upright)
kicknrun=Kick and Run
kicker=Kicker
kbash=Knuckle Bash
karnovr=Karnov's Revenge / Fighter's History Dynamite
kchampvs=Karate Champ (US VS version)
kchamp=Karate Champ (US)
junglkj2=Jungle King (Japan
junglers=Jungler (Stern)
junofstg=Juno First (Gottlieb)
junofrst=Juno First
jungleh=Jungle Hunt (US)
jumpshot=Jump Shot
jungler=Jungler
junglek=Jungle King (Japan)
jyuohki=Jyuohki (Japan)
kaitein=Kaitei Takara Sagashi (Namco)
kaiteids=Kaitei Daisensou (Japan)
kangaroa=Kangaroo (Atari)
kamikaze=Kamikaze
kageki=Kageki (US)
kabukikl=Kabuki Klash - Far East of Eden / Tengai Makyou Shinden - Far East of Eden
kaitei=Kaitei Takara Sagashi
kagekij=Kageki (Japan)
kof95=The King of Fighters '95
kof94=The King of Fighters '94
kof97=The King of Fighters '97
kof96=The King of Fighters '96
kodb=The King of Dragons (bootleg)
kod=The King of Dragons (World)
kodure=Kodure Ookami (Japan)
kodj=The King of Dragons (Japan)
kof98=The King of Fighters '98 - The Slugfest / King of Fighters '98 - dream match never ends
kram=Kram (set 1)
kotm2=King of the Monsters 2 - The Next Thing
kroozr=Kozmik Kroozr
kram2=Kram (set 2)
konamigt=Konami GT
konami88=Konami '88
kotm=King of the Monsters
koshien=Ah Eikou no Koshien (Japan)
killcom=Killer Comet
kikstart=Kick Start Wheelie King
kingball=King & Balloon (US)
kingbalj=King & Balloon (Japan)
kidniki=Kid Niki - Radical Ninja (US)
kickridr=Kick Rider
kikikai=KiKi KaiKai
kikcubic=Meikyu Jima (Japan)
kingofb=King of Boxer (English)
knights=Knights of the Round (World)
klaxj=Klax (Japan)
knockout=Knock Out !!
knightsj=Knights of the Round (Japan)
klax=Klax (set 1)
kizuna=Kizuna Encounter - Super Tag Battle / Fu'un Super Tag Battle
klax3=Klax (set 3)
klax2=Klax (set 2)
indytemp=Indiana Jones and the Temple of Doom (set 1)
indytem4=Indiana Jones and the Temple of Doom (set 4)
insectx=Insector X (World)
inferno=Inferno
indyheat=Danny Sullivan's Indy Heat
imsorryj=I'm Sorry (Japan)
indytem3=Indiana Jones and the Temple of Doom (set 3)
indytem2=Indiana Jones and the Temple of Doom (set 2)
inthunt=In The Hunt (World)
invaderl=Space Invaders (Logitec)
invaddlx=Space Invaders Deluxe
invadpt2=Space Invaders Part II (Taito)
invaders=Space Invaders
intrepi2=Intrepid (set 2)
inthuntu=In The Hunt (US)
invad2ct=Space Invaders II (Midway, cocktail)
intrepid=Intrepid (set 1)
hydra=Hydra
hwrace=High Way Race
hyperspt=Hyper Sports
hydrap=Hydra (prototype)
hustlerb=Video Hustler (bootleg)
hustler=Video Hustler
hwchamp=Heavyweight Champ
hvymetal=Heavy Metal
hyprolyb=Hyper Olympic (bootleg)
ikarijpb=Ikari Warriors (Japan bootleg)
ikarijp=Ikari Warriors (Japan)
imsorry=I'm Sorry (US)
imgfight=Image Fight (Japan)
hypsptsp=Hyper Sports Special (Japan)
hyprolym=Hyper Olympic
ikari3=Ikari III - The Rescue
ikari=Ikari Warriors (US)
joust=Joust (White/Green label)
journey=Journey
joustr=Joust (Solid Red label)
joust2=Joust 2 - Survival of the Fittest (set 1)
jedi=Return of the Jedi
janshin=Jyanshin Densetsu - Quest of Jongmaster
joemac=Joe & Mac (Japan)
jjack=Jumping Jack
joustwr=Joust (White/Red label)
jumpbugb=Jump Bug (bootleg)
jumpbug=Jump Bug
jumping=Jumping
jumpcoas=Jump Coaster
joyjoy=Puzzled / Joy Joy Kid
joyfulr=Joyful Road (US)
jspecter=Jatre Specter
jrpacman=Jr. Pac-Man
irobot=I, Robot
invrvnge=Invader's Revenge
irrmaze=The Irritating Maze / Ultra Denryu Iraira Bou
ironhors=Iron Horse
invho2=Invinco / Head On 2
invds=Invinco / Deep Scan
invrvnga=Invader's Revenge (Dutchford)
invinco=Invinco
jack=Jack the Giantkiller (set 1)
jackrabs=Jack Rabbit (special)
jackrab2=Jack Rabbit (set 2)
jailbrek=Jail Break
jackrabt=Jack Rabbit (set 1)
jack3=Jack the Giantkiller (set 3)
jack2=Jack the Giantkiller (set 2)
jackalj=Tokushu Butai Jackal (Japan)
jackal=Jackal (World)
krull=Krull
maniach2=Mania Challenge (set 2)
maniach=Mania Challenge (set 1)
mappyjp=Mappy (Japan)
mappy=Mappy (US)
makaimur=Makai-Mura
makaimug=Makai-Mura (Revision G)
makyosen=Makyou Senshi (Japan)
maketrax=Make Trax
marble=Marble Madness (set 1)
mariojp=Mario Bros. (Japan)
mario=Mario Bros. (US)
marukin=Super Marukin-Ban
mars=Mars
marblea=Marble Madness (set 3)
marble2=Marble Madness (set 2)
mariner=Mariner
marineb=Marine Boy
maglord=Magician Lord (set 1)
magix=Magix
magspot2=Magical Spot II
maglordh=Magician Lord (set 2)
madmotor=Mad Motor
madgearj=Mad Gear (Japan)
magdrop3=Magical Drop III
magdrop2=Magical Drop II
mahretsu=Mahjong Kyoretsuden
majuu=Majuu no Ohkoku
majtitle=Major Title (Japan)
makaimuc=Makai-Mura (Revision C)
makaiden=Makai Densetsu (Japan)
mainevt2=The Main Event (version F)
mainevt=The Main Event (version Y)
majtitl2=Major Title 2 (World)
majest12=Majestic Twelve - The Space Invaders Part IV (Japan)
mercs=Mercs (World)
megazone=Mega Zone
mercsu=Mercs (US)
mercsj=Senjo no Ookami II (Japan)
megaman=Mega Man - The Power Battle (Asia)
megaforc=Mega Force
megaznik=Mega Zone (Kosuka)
megatack=MegaTack
mermaid=Mermaid
mgakuen2=Mahjong Gakuen 2 Gakuen-chou no Fukushuu
mgakuen=Mahjong Gakuen
mhavoc2=Major Havoc (rev 2)
mhavoc=Major Havoc (rev 3)
meteor=Meteoroids
metafox=Meta Fox
mexico86=Mexico 86
metrocrs=Metro-Cross
masterw=Master of Weapon (World)
masao=Masao
maxrpm=Max RPM
matmania=Mat Mania
marvins=Marvin's Maze
marukodq=Chibi Marukochan Deluxe Quiz
marvlanj=Marvel Land (Japan)
marvland=Marvel Land (US)
mayday=Mayday (set 1)
mbombrdj=Muscle Bomber Duo - Heat Up Warriors (Japan)
mbombrd=Muscle Bomber Duo - Ultimate Team Battle (World)
medlanes=Meadows Lanes
mbrush=Magic Brush
mayhem=Mayhem 2002
maydaya=Mayday (set 2)
mbomberj=Muscle Bomber - The Body Explosion (Japan)
maze=Amazing Maze
lbowling=League Bowling
lazercmd=Lazer Command
ldrun2=Lode Runner II - The Bungeling Strikes Back
ldrun=Lode Runner (set 1)
lastduel=Last Duel (US set 1)
lastbld2=The Last Blade 2 / Bakumatsu Roman - Dai Ni Maku Gekkano Kenshi
lastmss2=Last Mission (US revision 5)
lastmiss=Last Mission (US revision 6)
ldrun3=Lode Runner III - Majin No Fukkatsu
leprechn=Leprechaun
legofair=Koukuu Kihei Monogatari - The Legend of Air Cavalry
levers=Levers
lethalth=Lethal Thunder (World)
ldruna=Lode Runner (set 2)
ldrun4=Lode Runner IV - Teikoku Karano Dasshutsu
legendos=Legend of Success Joe / Ashitano Joe Densetsu
ledstorm=Led Storm (US)
kungfum=Kung Fu Master
kungfud=Kung Fu Master (Data East)
kyros=Kyros
kuniokub=Nekketsu Kouha Kunio-kun (Japan bootleg)
kuhga=Kuhga - Operation Code 'Vapor Trail' (Japan revision 3)
ktiger=Kyukyoku Tiger (Japan)
kungfub2=Kung Fu Master (bootleg set 2)
kungfub=Kung Fu Master (bootleg set 1)
kyukaidk=Kyuukai Douchuuki (Japan new version)
laser=Laser
lagunar=Laguna Racer
lastblad=The Last Blade / Bakumatsu Roman - Gekkano Kenshi
lasso=Lasso
labyrunr=Labyrinth Runner (Japan)
kyukaido=Kyuukai Douchuuki (Japan old version)
ladybugb=Lady Bug (bootleg)
ladybug=Lady Bug
lsasquad=Land Sea Air Squad / Riku Kai Kuu Saizensen
lresort=Last Resort
lstduelb=Last Duel (bootleg)
lstduela=Last Duel (US set 2)
lostwrld=Lost Worlds (Japan)
losttomb=Lost Tomb (easy)
lrescue=Lunar Rescue
lotlot=Lot Lot
lupin3=Lupin III
mach3=M.A.C.H. 3
m79amb=M79 Ambush
madgear=Mad Gear (US)
madcrash=Mad Crasher
lwings2=Legendary Wings (US set 2)
lwings=Legendary Wings (US set 1)
m4=M-4
lwingsjp=Ales no Tsubasa (Japan)
liquidku=Liquid Kids (US)
liquidk=Liquid Kids (World)
lkage=The Legend of Kage
lizwiz=Lizard Wizard
liberatr=Liberator (set 1)
lgtnfght=Lightning Fighters (US)
lifefrcj=Lifeforce (Japan)
lifefrce=Lifeforce (US)
lkageb=The Legend of Kage (bootleg set 1)
lomakai=Legend of Makai (World)
loht=Legend of Hero Tonma
losttmbh=Lost Tomb (hard)
looper=Looper
lkageb3=The Legend of Kage (bootleg set 3)
lkageb2=The Legend of Kage (bootleg set 2)
locomotn=Loco-Motion
lnc=Lock'n'Chase
galap1=Space Invaders Galactica
galagamw=Galaga (Midway)
galapx=Galaxian Part X
galap4=Galaxian Part 4
galaga88=Galaga '88 (set 1)
galaga84=Galaga '84
galagads=Galaga (fast shoot)
galagab2=Galaga (bootleg)
galaxb=Galaxian (bootleg)
gallop=Gallop - Armed police Unit (Japan)
gallag=Gallag
galpanic=Gals Panic
galmidw=Galaxian (Midway)
galaxyfg=Galaxy Fight - Universal Warriors
galaxian=Galaxian (Namco)
galivan2=Galivan - Cosmo Police (12/11/1985)
galivan=Galivan - Cosmo Police (12/16/1985)
fshark=Flying Shark (World)
fround=Final Round
fstarfrc=Final Star Force (US)
fsharkbt=Flying Shark (bootleg)
frogseg1=Frogger (Sega set 1)
frogs=Frogs
frontlin=Front Line
frogseg2=Frogger (Sega set 2)
ftsoccer=Fighting Soccer
galaga=Galaga (Namco)
galag88j=Galaga '88 (Japan)
galaga3a=Galaga 3 (set 2)
galaga3=Galaga 3 (set 1)
futspy=Future Spy
funkybee=Funky Bee
galag88b=Galaga '88 (set 2)
gaiden=Ninja Gaiden (World)
galturbo=Galaxian Turbo
genpeitd=Genpei ToumaDen
gemini=Gemini Wing
getstarb=Get Star (bootleg)
gensitou=Genshi-Tou 1930's
gbusters=Gang Busters
gberetb=Green Beret (bootleg)
geebeeg=Gee Bee (Gremlin)
geebee=Gee Bee
gghost=Goalie Ghost
ghox=Ghox
ghoulsu=Ghouls'n Ghosts (US)
ginganin=Ginga NinkyouDen
gimeabrk=Gimme A Break
ghostb3=The Real Ghostbusters (US 3 Players)
ghostb=The Real Ghostbusters (US 2 Players)
ghoulsj=Dai Makai-Mura (Japan)
ghouls=Ghouls'n Ghosts (World)
gardia=Gardia
gaplusa=Gaplus (set 2)
garuka=Garuka (Japan)
gardiab=Gardia (bootleg)
gangwarb=Gang Wars (bootleg)
galxwars=Galaxy Wars
gaplus=Gaplus (set 1)
gangwars=Gang Wars (US)
garyoret=Garyo Retsuden (Japan)
gauntir2=Gauntlet (Intermediate Release 2)
gauntir1=Gauntlet (Intermediate Release 1)
gberet=Green Beret
gauntlet=Gauntlet
gatedoom=Gate of Doom (US revision 4)
gatedom1=Gate of Doom (US revision 1)
gaunt2p=Gauntlet (2 Players)
gaunt2=Gauntlet II
fantasyj=Fantasy (Japan)
fantasy=Fantasy (US)
fantzone=Fantasy Zone (Japan New Ver.)
fantazia=Fantazia
f1dreamb=F-1 Dream (bootleg)
f1dream=F-1 Dream
faceoff=Face Off (Japan)
f1gpstar=F1 Grand Prix Star
fantzono=Fantasy Zone (Old Ver.)
fatfury3=Fatal Fury 3 - Road to the Final Victory / Garou Densetsu 3 - haruka-naru tatakai
fatfury2=Fatal Fury 2 / Garou Densetsu 2 - arata-naru tatakai
fbfrenzy=Football Frenzy
fax=Fax
fastfred=Fast Freddie
farwest=Far West
fatfury1=Fatal Fury - King of Fighters / Garou Densetsu - shukumei no tatakai
fatfursp=Fatal Fury Special / Garou Densetsu Special
exctsccb=Exciting Soccer (bootleg)
exctscca=Exciting Soccer (alternate music)
exedexes=Exed Exes
exctsccr=Exciting Soccer
euroch92=Euro Champ '92 (World)
eswatbl=E-Swat (bootleg)
exctscc2=Exciting Soccer II
excthour=Exciting Hour
exerion=Exerion
extrmatn=Extermination (US)
exterm=Exterminator
eyes2=Eyes (Techstar Inc.)
eyes=Eyes (Digitrex Techstar)
exeriont=Exerion (Taito)
exerionb=Exerion (bootleg)
exprraid=Express Raider (US)
exodus=Exodus (bootleg?)
ffantasy=Fighting Fantasy (Japan)
fnkyfish=Funky Fish
flyboyb=Fly-Boy (bootleg)
footchmp=Football Champ (World)
foodf=Food Fight
flipshot=Battle Flip Shot
flicky2=Flicky (set 2)
flyboy=Fly-Boy
flkatck=Flak Attack (Japan)
forgottn=Forgotten Worlds (US)
frogger=Frogger
friskyt=Frisky Tom
froggrmc=Frogger (modified Moon Cresta hardware)
froggers=Frog
fpointbl=Flash Point (bootleg)
fpoint=Flash Point
frenzy=Frenzy
freeze=Freeze
finalb=Final Blow (World)
fightfev=Fight Fever / Crystal Legacy
finalizb=Finalizer - Super Transformation (bootleg)
finalbj=Final Blow (Japan)
ffightj=Final Fight (Japan)
ffight=Final Fight (World)
fhawk=Fighting Hawk (Japan)
ffightu=Final Fight (US)
finalizr=Finalizer - Super Transformation
fitter=Fitter
fitegolf=Fighting Golf
flicky=Flicky (set 1)
flashgal=Flash Gal
fireone=Fire One
finehour=Finest Hour (Japan)
firetrap=Fire Trap
firetpbl=Fire Trap (Japan bootleg)
hangly2=Hangly-Man (set 2)
hangly=Hangly-Man (set 1)
hardhat=Hard Hat
hangon=Hang-On
hal21=HAL21
gyrussce=Gyruss (Centuri)
hanaawas=Hana Awase (Flower Matching)
hal21j=HAL21 (Japan)
hatena=Adventure Quiz 2 Hatena Hatena no Dai-Bouken (Japan)
hcastlea=Haunted Castle (set 2)
hcastle=Haunted Castle (set 1)
headon=Head On (2 players)
hcastlej=Akuma-Jou Dracula (Japan)
hattrick=Hat Trick
hatris=Hatris (Japan)
hbarrelw=Heavy Barrel (World)
hbarrel=Heavy Barrel (US)
gunsmrom=Gun.Smoke (US set 1)
gunsmokj=Gun.Smoke (Japan)
gutangtn=Guttang Gottong
gururin=Gururin
gunhohki=Gun Hohki (Japan)
gunfront=Gun & Frontier (World)
gunsmoke=Gun.Smoke (World)
gunsmoka=Gun.Smoke (US set 2)
guzzler=Guzzler
gypsyjug=Gypsy Juggler
gwarrior=Galactic Warriors
gyruss=Gyruss (Konami)
gyrodine=Gyrodine
gwara=Guerrilla War (Version 1)
gwar=Guerrilla War (US)
gwarj=Guevara (Japan)
gwarb=Guerrilla War (bootleg)
hooku=Hook (US)
hook=Hook (World)
hopprobo=Hopper Robo
hopmappy=Hopping Mappy
hoccer=Hoccer (set 1)
hitnmiss=Hit 'n Miss (version 3.0)
homo=Homo
hoccer2=Hoccer (set 2)
horshoes=American Horseshoes (US)
hunchbkd=Hunchback (Donkey Kong conversion)
hthero=Hat Trick Hero (Japan)
hustle=Hustle
hunchbks=Hunchback (Scramble hardware)
hotshock=Hot Shocker
hotchase=Hot Chase
hpuncher=Hard Puncher (Japan)
hpolym84=Hyper Olympics '84
helifire=HeliFire (revision B)
helifira=HeliFire (revision A)
herbiedk=Herbie at the Olympics (DK conversion)
hellfire=Hellfire
headonb=Head On (1 player)
headon2=Head On 2
heiankyo=Heiankyo Alien
heberpop=Hebereke no Popoon (Japan)
hexa=Hexa
hishouza=Hishou Zame (Japan)
hippodrm=Hippodrome (US)
hitnmis2=Hit 'n Miss (version 2.0)
hitice=Hit the Ice (US)
hharryu=Hammerin' Harry (US)
hharry=Hammerin' Harry (World)
hiimpact=High Impact Football (rev LA3 12/27/90)
higemaru=Pirate Ship HigeMaru
gradius=Gradius
ginkun=Ganbare Ginkun
gradius3=Gradius III (Japan)
gpilots=Ghost Pilots
gorfpgm1=Gorf (Program 1)
gotya=Got-Ya (12/24/1981, prototype?)
gowcaizr=Voltage Fighter - Gowcaizer / Choujin Gakuen Gowcaizer
gravitar=Gravitar (version 3)
grescue=Galaxy Rescue
gridiron=Gridiron Fight
grindstm=Grind Stormer (Korea)
grdius3a=Gradius III (Asia)
gravitr2=Gravitar (version 2)
grdius2a=Gradius II - Gofer no Yabou (Japan set 2)
grdius2b=Gradius II - Gofer no Yabou (Japan set 3)
gorf=Gorf
gngt=Ghosts'n Goblins (US)
goalx3=Goal! Goal! Goal!
goindol=Goindol
gnga=Ghosts'n Goblins (World? set 2)
gladiatr=Gladiator (US)
gmissile=Guided Missile
gng=Ghosts'n Goblins (World? set 1)
goldmedl=Gold Medalist
goldnaxe=Golden Axe (Version 1)
goldnaxj=Golden Axe (Version 1
gondo=Gondomania (US)
goldnaxc=Golden Axe (Version 2 317-0122)
goldnabl=Golden Axe (bootleg)
goldnaxa=Golden Axe (Version 2)
goldnaxb=Golden Axe (Version 2 317-0110)
gteikoku=Gingateikoku No Gyakushu
growlu=Growl (US)
growl=Growl (World)
gunforce=Gunforce - Battle Fire Engulfed Terror Island (World)
grobda3=Grobda (Old version set 2)
gundealr=Gun Dealer (set 1)
gunfight=Gun Fight
gundeala=Gun Dealer (set 2)
gryzor=Gryzor
gunbird=Gun Bird (Japan)
gunfronj=Gun Frontier (Japan)
gunforcu=Gunforce - Battle Fire Engulfed Terror Island (US)
gsword=Great Swordsman
gradius2=Gradius II - Gofer no Yabou (Japan set 1)
grobda=Grobda (New version)
grobda2=Grobda (Old version set 1)
renegade=Renegade (US)
64street=64th. Street - A Detective Story (World)
topracer=Top Racer
tigerh=Tiger Heli (set 1)
aafbb=All American Football (rev B)
kuniokun=Nekketsu Kouha Kunio-kun (Japan)
aafb=All American Football (rev E)
tigerh2=Tiger Heli (set 2)
64streej=64th. Street - A Detective Story (Japan)
soldamj=Soldam (Japan)
psurge=Power Surge
getstarj=Get Star (Japan)
cybattlr=Cybattler
lordofk=The Lord of King (Japan)
ringkin3=Ring King (set 3)
iganinju=Iga Ninjyutsuden (Japan)
getstar=Guardian
llander=Lunar Lander (rev 2)
samesame=Same! Same! Same!
waterski=Water Ski
meikyuh=Meikyuu Hunter G (Japan)
llander1=Lunar Lander (rev 1)
gtmre=Great 1000 Miles Rally (Evolution Model)
formatz=Formation Z
fireshrk=Fire Shark
slapfigh=Slap Fight
hachoo=Hachoo!
machomou=Macho Mouse
monkeyd=Monkey Donkey
chimerab=Chimera Beast
astyanax=The Astyanax
pignewta=Pig Newton (version A)
pignewt=Pig Newton (version C)
vimanan=Vimana (Nova Apparate GMBH & Co)
superbon=Super Bond
vimana=Vimana (set 1)
brain=Brain
vimana2=Vimana (set 2)
insector=Insector (prototype)
bigstrik=Big Striker
tturf=Tough Turf (Japan)
fastlane=Fast Lane
tigerhj=Tiger Heli (Japan)
gtmr=Great 1000 Miles Rally
aeroboto=Aeroboto
spacedem=Space Demon
kickoff=Kick Off (Japan)
alibaba=Ali Baba and 40 Thieves
schaser=Space Chaser
tshingen=Takeda Shingen (Japan)
puzznic=Puzznic (Japan)
mrtnt=Mr. TNT
alcon=Alcon